║══════════════════════════════════════════════════════════════════════════════════════════════════════════════════════════════════════════════════════════════════════════════════════════════║
║&                                                                                                                                                                                             ║
║                                                                                                                                                                                              ║
║                                                                                                                                                                                              ║
║                           ║║#########                                                                                                                                                        ║
║                           ║║########                                                                                                                                                         ║
║                           ║║#########                                                                                                                                                        ║
║                           ║║#########                                                                                                                                                        ║
║                           ║║###################                                                                                                                                              ║
║                           ║║###############                                                        ?                                                                                         ║
║                           ║║##############                                                                                                                                                   ║
║                           ═══════════════════════════════════════════════                                                                                                                    ║
║                                                                                                                                                                                              ║
║                                                                                                                                                                                              ║
║                                                                                                                                                                                              ║
║               #############                                                                                                                                                                  ║
║                #############                                                                                                                                                                 ║
║            #############                                                           ═══════════════════════════════                                                                           ║
║                                                                                 ║║#############       #############                                   ?                                      ║
║                                                                                 ║║#############       #############                                                                          ║
║                                                                                 ║║#############       #############                                                                          ║
║                                                                                 ║║#####?#######       #############                                                                          ║
║                                                                                 ║║#############   ?   #############                                                                          ║
║                                                                                 ║║#############       #############                                                                          ║
║                                                                                 ║║#############       #############                                                                          ║
║                                                        ?                        ║║#############       #############                                                                          ║
║                                                                                 ║║#############       #############                                                                          ║
║                                                                                 ║║#############       #############                                                                          ║
║                                                                                 ══════════════════════════════════════════════════════                                                       ║
║                                                                                                                                                                                              ║
║                                                                                                                                                       ?                                      ║
║                                                                                                                                                                                              ║
║                                                                                                                                                                                              ║
║                                                                                                                                                                                              ║
║                                                                                                                                                                                              ║
║                                                                                                                                                                                              ║
║                                                                                                                                                                                              ║
║                                                                                                                                                                                              ║
║                                                                                                                                                                                              ║
║                                                                                                                                                                                              ║
║                                                                                                                                                                                              ║
║                                                                                                                                                                                              ║
║                                                                                                                                                                                              ║
║                                                                                                                                                                                              ║
║                                                                                                                                                                                              ║
║                                                                                                                                                                                              ║
║                                                                                                                                                                                              ║
║                                                                                                                                                                                              ║
║══════════════════════════════════════════════════════════════════════════════════════════════════════════════════════════════════════════════════════════════════════════════════════════════║