║════════════════════════════════════════════════════════════════════════════════════════════════════════════════════════════════════════║
║                                                                                                                                        ║
║                                                                                                                                        ║
║                                                                                                                                        ║
║                           ║#########                                                                                                   ║
║                           ║########                                                                                                    ║
║                           ║#########                                                                                                   ║
║                           ║#########             &                                                                                     ║
║                           ║###################                                                                                         ║
║                           ║###############                                                                                             ║
║                           ║##############                                                                                              ║
║                                                                                                                                        ║
║                                                                                                                                        ║
║                                                                                                                                        ║
║                                                                                                                                        ║
║                                                                                                                                        ║
║                                                                                                                                        ║
║                                                                                 ═══════════════════════════════                        ║
║                                                                               ║                                                        ║
║                                                                               ║                                                        ║
║                                                                               ║                                                        ║
║                                                                               ║                                                        ║
║                                                                                ║                                                       ║
║                                                                               ║                                                        ║
║                                                                               ║                                                        ║
║                                                                               ║                                                        ║
║                                                                               ║                                                        ║
║                                                                               ║                                                        ║
║                                                                               ║ ══════════════════════════════════════════════════════ ║
║                                                                                                                                        ║
║                                                                                                                                        ║
║                                                                                                                                        ║
║                                                                                                                                        ║
║                                                                                                                                        ║
║                                                                                                                                        ║
║                                                                                                                                        ║
║                                                                                                                                        ║
║════════════════════════════════════════════════════════════════════════════════════════════════════════════════════════════════════════║